75
75
PPPPPPPPPPPPPPPPPPPPPPPPPPPPPPPPPPPPPPPPPPPPPPPPPPPPPPPPPPPPPPPPPPPPPPPPPPP
PPPPPPPPPPPPPPPPPPPPPPPPPPPPPPPPPPPPPPPPPPPPPPPPPPPPPPPPPPPPPPPPPPPPPPPPPPP
PPPPPPPPPPPPPPPPPPPPPPPPPPPPPPPPPPPPPPPPPPPPPPPPPPPPPPPPPPPPPPPPPPPPPPPPPPP
PPPBBBBBBBBBBBBBBBBBBBBBBBBAASSTTSSSSSSSSSSSSSSSSSSSSSSSSSSSSTTSSSSSSTTGPPP
PPPBBBBBBBBBBBBSSSSKSSSSSSSSAASSTTSSSSSSSSSSSSSSSSSSSSSSSSSSSSTTSSSSTTTTPPP
PPPBBBBBBBBBBTTSBBSSSGSSSSSSAASSTTSSSSSSSSDSSSSSSSSSGSSSSSSSSSSTTSSSTTTTPPP
PPPSSSTSTSTSTTTTSSSSSSSSSSSAASSSTTSSSSSSSSSSSSSSSSSSSSSSSSSSSSSSTTSSTTTTPPP
PPPSSTTTTTTTTSSTTSSSSTTSSSAADSSTTSSSSSSSSSSSSSSSSSSSSSSSSSSSSSSTTSSSTTSSPPP
PPPPPTTPPPPPPPPTTSSSSPPPPPPPPPPPPPPPPPPPPPTTTSTSTSTSSSSSSSSSSSSTTSSTTTTSPPP
PPPTTSSSSSSSSSSSSTTTTAATTATAATAATASSSSSSSSSSSSSXSSSSSSSSSSSSSSSSTTTTSTTSPPP
PPPSSSSSSSSSSSSSSSTSAAAATTTTTTTTTTTTSSSSSSSSSSSSSSSSSSSSSSSGSSSSSTTTTTTSPPP
PPPSSSSSSSSSSSSSSSSSAAAAATATTATTATTTTSSSSSSSSSSSSSSSSSSSSSSSSSSSSTTTTTTSPPP
PPPSSSSSSSSSSSSSSSSSAAAAAAAAAAATTASSTTTSSSSSSSSSSSSSSTTTSSSSSSSSTTSTTTTSPPP
PPPSSSSSSSSGSSSSSSSSAAAAAAAAAAAATTSSSTTTTTSSSSSSTTTTTTTTTTTTSTSTTTSTTSSSPPP
PPPSSSSSSSSSSSSSSSSSAAAAAAAAAAAATTSSTSTTTTTTTTTTTTTTTTAATTTTTTTTTTTSTSTTPPP
PPPSSSSSSSSSSSSSSSSSATTTAAAATTATTATTTTTSSSTTTTTTSSSSSTBBBBBBTSTTTTTTTTTMPPP
PPPSSSSSSSSSSSTTXTTTTTTTTTAATTTATTTTSTSSSSSSSSSSSSSSSBBBBBBBBSSTSTTTSTTMPPP
PPPSSSSSSSSSTTTTTTTTTAAATTAAAATATTSSSSSSSSSSSSSSSSSSSBBPPPPPPPPPPPPPPPPPPPP
PPPSSSSSSSTTTTSSSSSSAAAAAAAAAAATTASSSSSSSSSSSSSSSSSSSBBBBBBBBSSSSSTTTTTMPPP
PPPSSSSTTTTTSSSSSSSSAAAAAAAAAAAATTSSSSSSSSSSSSSSSSSSSBBBBBBBBSSSSSTTSSTMPPP
PPPTTTTTTTSSSSSSSSSSAAAAAAAAAAATTASSSSSSSSSSSSSSSSSSSBBBBBBBBSSSSSSTTSTMPPP
PPPTTTTSSSSSSSSSSSSSAAAAAAAAAATTAASSSSSSSSSSSSGSSSSSSBBBBBBBBSSSSSSTTSTMPPP
PPPSSSSSSSSSSSSSSSSSAAAAAAAAAATTAASSSSSSSSSSSSSSSSSSSSSSSSSSSSSSSSSSTTTMPPP
PPPSSSSSSSSSSSSSSSSSSSSSSSSSSSDTTSSSDSSSSSSSSSSSSSSSDDSSSSSSSSSSSSSSTTTMPPP
PPPSSSSSSSSSSSSSSSSSSSSSSSSSSSSTTSSSSSSSSSSSSSSSSSSSSSSSSSSSSSSSSSSSTTTTPPP
PPPSSSSSSSSSSSSSSSSSSSSSSSSSSSSTTSSSSSSSSSSSSSSSSSSSSSSSSSSSGSSSSSSTTTTSPPP
PPPSSSSSSSSSSSSSSKKSSSSSSSSSSSSGGSSSSSAAAAAAAAAAAAAAAASSSSSSSSSSSSSSSTTSPPP
PPPSSSSSSSSSSSSSSSSSSSSSSSSSSSTTSSSSSSAAAAAKAAAAAAAAAASSSSSSSSSSSSSSTTTTPPP
PPPSSSSSSSSSSSSSSSSSSSSSSSSSSSSTTSSSSSAAAAAAAAAAAAAAAASSSSSSSSSSSSSSSTTTPPP
PPPSSSSSSSSSSSSSSSSSSSSSSSSSSSTTSSSSSSAAAAAAAAAAAAAAAASSSSTTTTTTTTTTTSTTPPP
PPPMMMMMMMMMMMMSSSSSSSMMMMMMMMMMMMMMMMMMMMMMMMMMMMMMMMSSSSMMMMMMMTMMMMMMPPP
PPPTTTTTTSSSSSSSSSSSSSMMMMMMMMMMMMMMMMMMMMMMMMMMMMMMMMSSSSMMTTTTTTTMTTTSPPP
PPPSTTSSTTSSSSSSSSSSSSSSSSSSSTTSSSSSSSAAAAAAAAAAAAAAAASSSSTMTTTTTTTMTTTSPPP
PPPSSSSSSTTSSSSTTTSSSSSSSSSSTTSSSSSSSSAAAAAAAAAAAAAAAASSSSTMTTTTTTTMTSTTPPP
PPPSSSSSSSTTTTTTTXTSSGSSSSSTTAASSSSTSTTAAAAAAAAAAAAAAATSSSTMTTTTTTTMTSSTPPP
PPPSSSSGSSSTTTTSSSTTTTTSSSSSTTAASSTTTTTTAAAAAAAAAAAAATTTTTTMTTTTTTTMTSTTPPP
PPPSSSSSSSTSSSSSSSSTTTTTSSTSTTSAATTSTSATTTAATTAAAAAATTSTTTTMTTTTTTTTTTTSPPP
PPPSSSSSSTTTSSSSSSSSSSSTTTTTTSTSTTSSSSAATTTTTTTTAAATTASSSSTMTTTTTTTMTTTTPPP
PPPTSSSTTTSTTSTSSSSSSSSSTTSTTTTTTSSSSSAAAATTAATTTTTTAASSSSTMMMMMMMMMTSSTPPP
PPPTTTTTTSSSTTTTTSTSSTSSSSSSSTSTAASSSSAAAAAAAAAATTTAAASSSSTTTTTTTTTTTSTTPPP
PPPSTTTSSSSSSTSTTTTTTTTTTSSSTTSAASSSSSAAAADDAAAAAAAAAASSSSSSSSSSSSSSDDSTPPP
PPPSSSSSSSSSSSSSSTSTTSTTTTSSTTTSAASSSSAAAADDDPAAAAAAAASSSSSSSSSSSSPDDDTTPPP
PPPSSSSSSSSTTTTTTTTTTTSSSTTTTTTTAATSSSSSSSDTTKPSSSSSSSSSSSSSSSSSSPKTTDSTPPP
PPPSSSSSSSSTPPPPPPPPPTSSSSTTTSSTTTSTSSSSSSDTTKKDDSSSSSSSSSSSSSSDDKKTTDSSPPP
PPPSSSSSSSSTPTTTTTTTPTSSSSSTTSSSSSSSSSSSSSSDTKKKKPSSSSSSSSTTTSPKKKKTDSSTPPP
PPPSSSSSSSSTPTTTTTTTPTSSSSSSTTSSSTSSSTTSSSSDTKKKKKDDSSDDDDTTDDKKKKKTDTSSPPP
PPPSSSSSSSSTPTTPPPTTTTSSSSSSTTSTTTTTTSTSTSSTDKKKKKKKPPKKKKPPKKKKKKKDTSSTPPP
PPPSSSSSSSSTPTTPPPTTPTSSSSSSTTTTTTTSTTTTTTTTDKKKKKKKKKKKKKKKKKKKKKKDSSSSPPP
PPPSSSSSSSSTPTTPPPTTPTSSSSSTSSSSSSSSSSSSTSTTTPKKKKKKKKKKKKKKKKKKKKPSTTSSPPP
PPPSSSSSSSSTPTTTTTTTPTSSSSSSTTSSSSSSSSSSSSSSSSPKPKKKKKKKKKKKKKKPKPSSSTSSPPP
PPPSSSSSSSSTPTTTXTTTPTSSSSSSSTTSSSSSSSSSSSSSSSSDKKKKKKKKKKKKKKKKDSTTTTTTPPP
PPPSSSSSSSSTPPPPPPPPPTSSSSSSTTSSSSSSSSSSSSSSSSSDKKKKKKKKKKKKKKKKDTTTTSTTPPP
PPPSSSSSSSSTTTTTTTTTTTAATTTTTTTTTTTSSSSSSSSSSSPKKKPPKKKKKKKKPPKKKPSSTTSSPPP
PPPSSSSSSSSSSSSSSSAAAAAATMMMMMMMMMTSSSSSSSSSSSPKKPGPPKKKKKKPPGPKKPSSTTSSPPP
PPPSSSKSSSSSSSSSSSAAAAAATMTTTTTTTMTSSSSSSSSSSSPKKPPPPKKKKKKPPPPKKPSTSTTTPPP
PPPSSSSSSSSSSSSSSSAAAAAATMTTTTTTTMTSSSSSSSSSSSPKKKPPKKKPPKKKPPKKKPTTTTATPPP
PPPSSSSSSSSSSSSSSSAAAAAATMTTMMMTTTTSSSSSSSSSSDKKTTKKKKKKKKKKKKTTKKDAATTAPPP
PPPSSSSSSSSGSSSSSSAAAAAATMTTMMMTTMTSSSSSSSSSSDKTTTTKKPKPPKPKKTTTTKDSATTAPPP
PPPSSSSSSSSSSSSSSSAAAAAATMTTMMMTTMTSSSSSSKSTTDKTTTTKKKPTTPKKKTTTTKDSTTAAPPP
PPPSSSSSSGSSSSSSSSAAAAAATMTTTTTTTMTSSSSSSSSTTSPKTTKKKKPTTPKKKKTTKPSATTATPPP
PPPSSSSSSSSSSSSSSSAAAAAATMTTTTTTTMTSSSSSSSTTSTTPKKKKKKPTTPKKKKKKPSATTATTPPP
PPPSSSSSSSSSSSSSSSAAAAAATMMMMMMMMMTSSSTSSTTTTTTSDDKKKKKTTKKKKKDDSAAAATTAPPP
PPPSSSSSSSSKSSSSSSSSSSSSTTTTTTTTTTTTSSTTTTSSTSSSSSPPPKKKKKKPPPSAAAAATTTTPPP
PPPSSSSSSSSSSSSSSSSSSSSSSSSSTTSSSSTTTTTTTSSSSSSSSSSSSDDDDDDSSSAAAAATTAATPPP
PPPSBBBBBBBBBBBBBBSTSTSSSTSTTAASTTTSTTTSSSSSSGSSSSSSSSSSSSSSSSAAAAATTATTPPP
PPPSBBBBTBBBTTBBBBTTTTTSTTTTAATTTTSSSTSSSSSSSSSSSSSSSSSSSSSSSSAAAAATTAATPPP
PPPSBBBTTTBTTTTBBTTSTSTTTTTAASTTSSSSSASSSSSSSSSSSSSSSSSSSSSSSSAAAAATTATTPPP
PPPSTBTTBTTTBBTTTTSSSSSTTTSSAASSSSSSAAAASSSSSSSSSASSSSSSSSSSSSAAAATTATTAPPP
PPPTTTTBBBTBBBBTTBSSSSSTTSAAAAASSASAASAAASSSSSSAAAASSSSSSSSSSSAAAAATTTTAPPP
PPPTBTBBBBBBBBBBBBSASAASTTAASAAAAAAASSSSAASSAAAAASAAAASSSSSSSAAAAAAAATTTPPP
PPPSBBBBBBBBBBBBBBAAAAATTSSTTASAASASSSSSSAAAAAASSSSAAAAASSAAAAAAAAAATTTTPPP
PPPPPPPPPPPPPPPPPPPPPPPPPPPPPPPPPPPPPPPPPPPPPPPPPPPPPPPPPPPPPPPPPPPPPPPPPPP
PPPPPPPPPPPPPPPPPPPPPPPPPPPPPPPPPPPPPPPPPPPPPPPPPPPPPPPPPPPPPPPPPPPPPPPPPPP
PPPPPPPPPPPPPPPPPPPPPPPPPPPPPPPPPPPPPPPPPPPPPPPPPPPPPPPPPPPPPPPPPPPPPPPPPPP
PPPPPPPPPPPPPPPPPPPPPPPPPPPPPPPPPPPPPPPPPPPPPPPPPPPPPPPPPPPPPPPPPPPPPPPPPPP
