50
50
PPPPPPPPPPPPPPPPPPPPPPPPPPPPPPPPPPPPPPPPPPPPPPPPPP
PPPPPPPPPPPPPPPPPPPPPPPPPPPPPPPPPPPPPPPPPPPPPPPPPP
PPPPPPPPPPPPPPPPPPPPPPPPPPPPPPPPPPPPPPPPPPPPPPPPPP
PPPBBSBSSSSSPPPTTTPPPTTTPPPTTTPPPTTTPPPSSSSSSSSPPP
PPPBBSBBSSSSSPPPTTTPPPTTTPPPTTTPPPTTTPPPSSSXSSSPPP
PPPBBSSBBSSSSSPPPGTTPPPTTTPPPXTTPPPTGTPPPSSSSSSPPP
PPPBBXPPPBBSPPPTTTPPPTTTPPPTTTPPPTTTPPPSSSPPPSSPPP
PPPBBSSPPPBBSPPPTTTPPPTTTPPPTTTPPPTTTPPPSSSPPPSPPP
PPPBBSSSPPPBBBPPPTTTPPPTTTPPPTTTPPPTTAPPPSSSPPPPPP
PPPBBSSSSPPPBBBPPPBTTPPPTTTPPPTTTPPPTASPPPSSSPPPPP
PPPBBSSBSSBBBBBBBBBBTTTTTTTTTTTTTTTTTASSAASAAAAPPP
PPPABSSBSSBBBBBBBBBBTTTTTTTTTTTTTTTTTASSAAAATTTPPP
PPPASSSSSSBBBBBBBBBBTTTTTTTTTTTTTTTTTAASSAAATTTPPP
PPPAAKSSSBBBBBBBBBBBBBTTTTTTTTTTTTTTTAAASSTTTTTPPP
PPPBAASSSBBBBBBBBMBBMBTTTTTTTTTMTTTTPAAAASSTTDTPPP
PPPBAAABSSBBBBBBBMMBMBTMTMTTTTTMTTPTTPAAASSTTTTPPP
PPPBSAABBSSBBBBBBMBMMBTMTMTTTTTMTTTTTPTTGSTTTTTPPP
PPPSBAAAABSSBSSBBMBBMBTTMTTTMTTMTTPTTPTTSSTTTTTPPP
PPPSSSAAASDSSSSSBMBBMBTMTTTTTMMTTTTTPTTSSAATTTTPPP
PPPBSSSAAABBSSBSSSSBBBTTTTTTTTTTTTTTTTTSSBBBBBBPPP
PPPBSSBBAABBBSSBSBSSBBTTTTDTTTTTKTTTTTTSSBBBBBBPPP
PPPBBSSSSAABBSSBBBBSBSDTTTSSSTTTTTTTTTTSSKBBBBBPPP
PPPBBSSSSBAABSSBBBBBBSSSTSSSSSTTTTTTTTTTSSBBBBBPPP
PPPBBBSSSSBAASSBBBBBTTSSSSTTTSTSTTTTTTSTSSSSBBBPPP
PPPTTTTSSTTTATSSTTTTTTTTSSTTXTSSSTTSTSSSSBSSSBSPPP
PPPTTKSSTTTTTSSTTTSTSTTTSSSSTSSSSSSSSSSSAABBSSSPPP
PPPTTTTSSPTTTSSTTSSSSSTSSTSSSSTSTSXTSSSAABBBBSSPPP
PPPTGTSPTPTPTSSTSSTSTSSSTTTTSTTTTTTTTTSSBBBBBBSPPP
PPPTTSSSPPPTTSSSSTKTTTSTTTTTTTTTTTTTTSMAABBBBBKPPP
PPPTTTPPPPPPPTSSTTTTTTTTTTTTTTTTTTTTTTSSBBBBBBBPPP
PPPTSTSSPPPSSSSTTTTTTTTTTPTPPPPPTTTTTTTTSSBBBBBPPP
PPPSSSSPSPSPTSTTTTTTTTTTTPTPTTTPDTTTTTTSSBBBBBBPPP
PPPSTTSSSPTTTSSTTKTTTTTTTPTPTPTPTTTTTTSSBBBBBBBPPP
PPPTTASSAAAASSATTTTTTTTTTPTPTPTPTTTTTTTSSBBBBBBPPP
PPPTTSSAAAAASSATTTTTTTTTTPTPTPTPTTTTTTTSSBBBBBBPPP
PPPTTASSAAASSAATTTTGTTTTTPTPPPTPBBBBBBSSSBBBBBSPPP
PPPTSASSAAASSAATTTTKTTTTTPTTTTTPBBBBBSSBGSSBBSSPPP
PPPSSSSSSSSSSSATSTTSSTSSSPPPPPPPBBBSSSBSSBSSSSBPPP
PPPSTSSSSSSAASSSSSSSSSSSSSTSSSSSBSSSSBSSSBSSSSBPPP
PPPTTASSAAAAASSSTSSTTSTTTTTSSSSSSSSBASSBSSSAASSPPP
PPPTTASSAAAASSSBBBBBBBSBBBSSBSBBSBBAASSBASTAABSPPP
PPPTGAASSAASSASSSBSBBSSSBSSTBBBBAAAASSAAABTTBBBPPP
PPPTTSSSSSSSAAASSSSSSSASSSATBAAAAAABSSAABBTTBBBPPP
PPPSSSSTBSSBAAABBSBSSBAASBAAAAAABBBBSSBAABTTBBBPPP
PPPSSTSSBBBBSSABBBBBBBBABBSAABBBBBBSSBBBAATTBBBPPP
PPPTTSSTBBBBSSBBBBBBBBBBBBSSBBBBBBBSSBBBBAATBKBPPP
PPPTTTSSSSSSSSSSSSSBBKBBBBSSBBBBBBBBSSBBBAATBBBPPP
PPPPPPPPPPPPPPPPPPPPPPPPPPPPPPPPPPPPPPPPPPPPPPPPPP
PPPPPPPPPPPPPPPPPPPPPPPPPPPPPPPPPPPPPPPPPPPPPPPPPP
PPPPPPPPPPPPPPPPPPPPPPPPPPPPPPPPPPPPPPPPPPPPPPPPPP
