100
100
PPPPPPPPPPPPPPPPPPPPPPPPPPPPPPPPPPPPPPPPPPPPPPPPPPPPPPPPPPPPPPPPPPPPPPPPPPPPPPPPPPPPPPPPPPPPPPPPPPPP
PPPPPPPPPPPPPPPPPPPPPPPPPPPPPPPPPPPPPPPPPPPPPPPPPPPPPPPPPPPPPPPPPPPPPPPPPPPPPPPPPPPPPPPPPPPPPPPPPPPP
PPPPPPPPPPPPPPPPPPPPPPPPPPPPPPPPPPPPPPPPPPPPPPPPPPPPPPPPPPPPPPPPPPPPPPPPPPPPPPPPPPPPPPPPPPPPPPPPPPPP
PPPTTTSSTTTSSTTTTTTTTTTTTTSSTTTTTTTTTTTTTTTTTTMMTTTTTTTTTTTTTTSSTTTTAATTTTSTTTTTTTTTSSTTTTSSTTTTTPPP
PPPTTTSSTTTTSSTTTTTTTTTTTTSSTTTTTTTTTTTTTTTTTTMMTTTTTTTTTTTTTTTSSTTAATTTTTSSTTTTTTTTSSTTTSSTTTTTTPPP
PPPTTTTSSTTSSTTTTTTTTTTTTTTSSTTTTTTTTTTTTTTTTTMMTTTTTTTTTTTTTTBSSBBAABBBTTTSSSTTTTTSSSTTTSSTTTTTTPPP
PPPTTTTSSTSSTTTTTTTTTTTTTTTSSTTTTTTTTTTTTTTTTTMMTTTTTTTTTTTTTTSSSSBBAABBTTTTTSSSTSSSSTTTTSSTTTTTTPPP
PPPTTTTSSTTSSTTTTTTTTTTTTTTTSSTTTTTTTTTTTTTTTTMMTTTTTTTTTTTTTTBSSBBAABBBTTTTTTTSSSTSSTTTTSSTTTTTTPPP
PPPSTTSSTTTSSTTTTTTTTTTTTTTTSSTTTTTTTTTTTTTTTTMMTTTTTTTTTTTTTTSSBBAABBBBTTTTTTTTTTTSTTTTTTSSTTTTTPPP
PPPSSTTSSTSSSSSSTTTTTTTTTTTTTSSTTTTTTTTTTTTTTTMMTTTTTTTTTTTBBBBSSAABBBBSSSSSSSSSSSSSSTTTTTTSSTTTTPPP
PPPTSSSSSSSSSSSSSSTSTSTTTTTTTTSSTTTTTTTTTTTTTTMMTTTTTTTTTTTBBBBBSSABBBBSSSSSSSSSSSSSSTTTTTTSSTTTTPPP
PPPTTSSTTSSSTTTTSSSSSSSSSTTTTTSSTTTTTTTTTTTTTTMMTTTTTTTTTTTBBBBSSAABBBBSSSSSSSSSSSSSSBBTTTTSSTTTTPPP
PPPTTTSSTTTSSAAAAASTSTSSSSSTTSAAAATTTTTTTTTTTSMMTTTTTTTTTTTBBBBBSSABBBBSSSSSSSSSSSSSSBBTTTTSSTTTTPPP
PPPTTTSSTTSSAAAAAAAATTTTTSSSAAAAAAATTTTSTTTTSSMMTTTTTTTTTTTBBBBSSBAABBBSSSSSSSSSSSSSSBBTTTTSSTTTTPPP
PPPTTSSTTSSAAAAAAAAATTTTTTTSAAAAAAAATTSSSSTSSTMMSTTTTTTTTTTBBBBBSSABBBBSSSSSSSSSSSSSSBBTTTSSTTTTTPPP
PPPTTSSTSSTAAADDAAAATTTTTTTAAAAAAAAATSSTSSSSTTMMSSSSSTSTTTTBBBBSSSAABBBSSSSSSSSSSSSSSBBTTTTSSTTTTPPP
PPPTTTSSSSAAAADDAAAATTTTTSSAAAADDAAAASSTTTSTTTMMTTSSSSSSTTTBBBBSSAABBBBSSSSSSSSSSSSSSBBTTTSSTTTTTPPP
PPPTTTTSSAAAAAAAAAATTTTTTSSSAAADDAAAAASTTTTTTTMMTTTTTSTSSSTBBBBSSSABBBBSSSSSSSSSSSSSSBBTTTTSSTTTTPPP
PPPTTTSSSAAAAAAAAATTTTTTTSSSSAAAAAAAAASTTTTTTTMMTTTTTTTTSSSBBBBBSAAKKKKKKKKKKSSSSSSSSBBTTTTSSTTTTPPP
PPPTTTTTSAAAAAAAAATTTTTTTSSSSAAAAAAAAASTTTTTTTMMTTTTTTTTTTSSBBBSSSAKKKKKKKKKKSSSSSSSSBBTTTTTSTSTTPPP
PPPTTTTSSAAAAAAAAATTTTTDDSSSSAAAAAAAAASTTTTTTTXXTTTTTTTTTTTSSBSSSSKKKKKKKKKKSSSSSSSSSBBTTTSSSSSSTPPP
PPPTTTSSSAAAAAAAAAATTTTTTSSSAAAAAAAAAASTTTTTTTXXTTTTTTTTTTTBSSSBSDKKKKKKKKKKSSSSSSSSSSSSSSSSTSTSSPPP
PPPTTTTSSAAAAAAAAAAATTTTTSSAAAAAAAAAAASTTTTTTTXXTTTTTTTTTTTBBSBBBKKKKKKKKKKSSSSSSSSSSSSSSSSTSSTTSPPP
PPPTTTTSSSAAAAAAAAAAAAAAAAAAAAAAAAAAASSTTTTTTTXXTTTTTTTTTTTBBBBBDKKKKKKKKKKSSSSSSSSSBSSSSSSSSSTSTPPP
PPPSSSSSSSSAAAAAAAAAAAAAAAAAAAAAAAAAASSTTTTTTTXXTTTTTTTTTTTBBBBDKKKKKKKKKKBBSSSSBBSSBSSSSSSSSSSSTPPP
PPPSSSSSSSSAAAAAAAAAAAAAAAAAAAAAAAAASSSTTTTTTTXXTTTTTTTTTTTBBSSDKKKKKKKKKKBBBBBBBBBBBSSSSSTTSSSTTPPP
PPPSSSSSSSSSAAAAAAAAAAAAAAAAAAAAAAASSSSTTTTTTTXXTTTTTTTTTTTSSSSKKKKKKKKKKBBBBBBBBBBBBSSSSSTTSSTTTPPP
PPPSSSSSSSSSSAAAAAAAAAATTSSAAAAAAASSSSSTTTTTTTXXTTTTTTTTSTSSSDDKKKKKKKKKKDTTTTTTTTTTTSSSSSTTTSSTTPPP
PPPSSSSSSSSSSSAAAAAAATTTTSSSSAAAASSSSSSTTTTTTTXXTTTTTTTSSSSTTDKKKKKKKKKKBBBBBBBBBBBBBSSSSSTTTTSSTPPP
PPPSSSSSSSBBSSSSAAAATTTTTSSSSSAASSSSSSSTTTTTTTXXTTTTTTSSTSTTTDKKKKKKKKKKBBBBBBBBBBBBBSSSSSTTTTTSSPPP
PPPSSSSSSBBBBBSSSSSSTTTTTSSSSSSSSSSSSSSTTTTTTTXXTTTTTSSTTTTTTKKKKKKKKKKDBBBBBBBBBSSSSSSSSSTTTTSSTPPP
PPPSSSSSSBBBBBSSSSTTTTTTTTTTTTTTTTTTTTTTTTTTTTXXTTSTSSTTTTTTTKKKKKKKKKKKKKKBBBBSSSSBBSSSSSTTTTSSTPPP
PPPSSSSSSSSSBBBSSTTTAAAAAAAATTTTTTTTTTTTTTTTTTXXTSSSSTTTTTTTKKKKKKKKKKKKKKKBBBSSBBSSBSSSSSTTTTTSSPPP
PPPSSSSSSBBSSBBSTTAAAAAAAAAAATTTTTTTTTTTTTTTTTXXSSTSTTTTTTTTKKKKKKKKKKKKKKBBBSSBBBBSSSSSSSTTTTTSSPPP
PPPSSSSBBBBSSBBBSTAAAAAAAAAAATTSSSSSSSSSSSSSTSXXSTTTTTTTTTTTTTDDTSKKKKKKKKBBSSBBBBBBBSSSSSTTTTSSTPPP
PPPSSSSBBBBSSBBBBTTAAAADDAAATTTSSSSSSSSSSSSSSSXXTTTTTTTTTTTTTTAASKKKKKKKKBBSSBBBBBBBBSSSSSTTTTTSSPPP
PPPSSSBBBBBSSBBBBSTTAAADDAAATTSSSSSSSSSSSTTTSTXXTTTTTTTTTTTTTTTADKKKKKKKBBSSBBBBBBBBBSSSSSTTTTSSTPPP
PPPSSSBBBBBSSBBBBBSTTAAAAAATTSSSSSSSSSSSSTTTTTXXTTTTTTTTTTTTTTTTKKKKKKKBBSSSBBBBBBBBBSSSSSSTTSSTSPPP
PPPSSSBBBBSSSBBBBBBSTTTTTTTTSSSSSSSSSSSSSTTTTTXXTTTTTTTTTTTTTTTDKKKKKKBBBSSBBBSSBBBBBSSSSSSSSSSSSPPP
PPPSSSBBBBSSBBBBBBBSSTTTTTSSSSSSSSSSSSSSSTTTTTXXTTTTTTTTTTTTTTTKKKKKKKBBBSBBBSSSSBBBBBBBTSSSSSTSSPPP
PPPSSSBBBBBSBBBBBBBBSSTTTSSSSSSSSSSSSSSSSTTTTTXXTTTTTTTTTTTTSSTKKKKKKTBBSBBBSSBBSSBBBBBBSSSTTTTTTPPP
PPPSSSBBBBSSBBBBBBBBSSTTTSSSSSSSSSSSSSSSSSTTTTXXTTTTTTTTTTSSSSKKKKKKTTBSSBSSSBBBBSSSSSBSSSTTTTTTTPPP
PPPTTTBBBBBSSBBBBBBBBSSSSSSSSSSSSSSSSSSSSSTTTTXXTTTTTTTTTSSSSSKKKKKKSTSSBSSSBBBBBBSSSSSSSSTTTTTTTPPP
PPPTTTBBBBSSBSBBBSBBBSSSSSSSSSSSSSSSSSSSSSSSSSXXSSSSSSSSSSSSSKKKKKKSSSSSSSSSSBBBBBBBBBSBSSTTTTTTTPPP
PPPSTTBBBBSSSSSBSSSBSSBSSSSSSSSSSSSSSSSSSSSSSSGGSSSSSSSSSSSSKKKKKKSSSSSSSBSSSSSSBBBBBBTTSSTTTTTTTPPP
PPPSSTTTTSSSSBSSSBSSSBBSSSSSSSSSSSSSSSSSSSSSSGGGGSSSSSSSSSSSKKKKKSSSSTSBBBBBBSSSSBBBBBTTSSTTTTTTTPPP
PPPTSSSTSSSSBBBSBBBSBBBSSSSSSSSSSSSSSSSSSSSSGGGGGGSSSSSSSTTKKKKKSSSTTTBBBBBBBBBBSSBBBBTTSSTTTTTTTPPP
PPPTTSSSSTSSBBBBBBBBBBBSSSSSSSSSSSSSSSSSSSSGGGGGGGGSSSSSSTTKKKKSSSSTTTBBBBBBBBBBBSSSSBTTSSTTTTTTTPPP
PPPTTTTSTSSBBBBBBBBBBBBSSSSSSSSSSSSSSSSSSSGGGGGGGGGGSSSSSTKKKKTTSSTTTTBBBBBBBBBBBBSSSSTTSSTTTTSSTPPP
PPPTTTTTTSSBBBBBBBBBBBBSSSSSSSSSSSSSSSSSSGGXXXXXXXXGGSSSSKKKKTTTTSSTTTBBBBBBBBBBBBBBBSSTSSSSTSSSSPPP
PPPTTTTTSSBBBBBBBBBBBBBSSSSSSSSSSSSSSSSSGGGXKKKKKKXGGGSSSKKKTTTTTSSTTTTTTTTTTTTTTTTTTTSSSSSSSSTTSPPP
PPPTTTTSSSSBBBBBBBBBBBBSSSSSSSSSSSSSSSSGGGGXKDDDDKXGGGGSSKKTTTTTTTSSTTTTTTTTTTTTTTTTTTTSSSTTSTTTTPPP
PPPMMMMMMMMMMMMMXXXXXXXXXXXXXXXXXXXXXXGGGGGXKDGGDKXGGGGGPPPXXXXXXXXXXXXXXXXXXXXXXMMMMMMMMMMMMMMMMPPP
PPPMMMMMMMMMMMMMXXXXXXXXXXXXXXXXXXXXXXGGGGGXKDGGDKXGGGGGPPPXXXXXXXXXXXXXXXXXXXXXXMMMMMMMMMMMMMMMMPPP
PPPTTSSSSTTTTTTTTTTTTTSSTTTTTTTTTTTTTTTGGGGXKDDDDKXGGGGSTSSSSSSSSSSSSSSSSSSSSSSSSSSSSSSSSSSSSSSSSPPP
PPPTSSTTSSTTTTTTTTTTTTTSSSTTTSSSSSSSTTSSGGGXKKKKKKXGGGSSTTSSSSSSSSSSSSSSSSSSSSSSSSSSSSSSSSSSSSSSSPPP
PPPTSSTTTSSTTTTTTTTTTTTSSSSSSTSSSSSSSSSSSGGXXXXXXXXGGSSSSTTSSSSTTTTTTTTTTTTTTTSSTTTTTTTTTTTTTTTSSPPP
PPPSSTTTTTSSTTTTTTTTTTTSSSSSSSSSSSSSSSSSSSGGGGGGGGGGSSSSSSTTSSSTKKKKKKKKKKKKKTSSTDDDDDDDDDDDDDTSSPPP
PPPTSSTTTSSTTTTTTTTTTTTTSSSSSSSSSSSSSSSSSSTGGGGGGGGSSSSSSSTTSSSTKTTTTTTTTTTTTTSSTDTTTTTTTTTTTTTSSPPP
PPPSSTTTSSTTTTTTTTTTTTTTBBSSSSSSSSSSSSSSSSSTGGGGGGSSSSSSSSSTTSSTKTKKKKKKKKKKKTSSTDTDDDDDDDDDDDTSSPPP
PPPSSTTTTSSTTTTTTTTTTTBBBBBBBSSSSSSSSSSSSTTTTGGGGSSSSSSSSSSSTSSTKTKTTTTTTTTTKTSSTDTDTTTTTTTTTDTSSPPP
PPPSSTTTTTSSTTTTTTTBBBBBBBBBBBBSSSSSSSSSSTTTTTGGSSSSSSSSSSSSSTSTKTKTKKKKKKKTKTSSTDTDTDDDDDDDTDTSSPPP
PPPTTTTTTTSSTTTTTBBBBBBBBBBBBBBBBSSSSSSSTTTTTTXXSSSSSSSSSSSSSTSTKTKTKTTTTTKTKTSSTDTDTDTTTTTDTDTSSPPP
PPPTTTTTTSSTTTTBBBBBBBBBBBBBBBBSSSSSSSSSTTTTTTXXSSSSSSSSSSSSTSSTKTKTKTKKKTKTKTSSTDTDTDTDDDTDTDTSSPPP
PPPTTTTTSSTTTTBBBBBBBBBBBBBBBBBSSSBBSSSTSTTTTTXXSSSSSSSSSSTTTSSTKTKTKTKTKTKTKTSSTDTDTDTDTDTDTDTSSPPP
PPPTTTTTSSTTTTBBBBBBBBBBBBBBBBSSSSBBBSSSTTTTTTXXSSSSSSSSSTTSSSSTKTKTKTKTKTKTKTSSTDTDTDTDTDTDTDTSSPPP
PPPTTTTTSSTTTBBBBBKKBBBBBBBBBBSSSBBBBSSSSTTTTTXXSSSSSSSSSTSSSSSTKTKTKTTTKTKTKTSSTDTDTDTTTDTDTDTSSPPP
PPPTTTTTTSSTBBBBBBKKSSBBBBBBBBSBBBBBBBSSTTTTTTXXSSSSSSSSTSSSSSSTKTKTKKKKKTKTKTSSTDTDTDDDDDTDTDTSSPPP
PPPTTTTTSSTTBBBBBBBBBSSBBBBBBSSSBBBBBBBSSTTTTTXXSSSSSSSSTSSSSSSTKTKTTTTTTTKTKTSSTDTDTTTTTTTDTDTSSPPP
PPPTTTTSSTTTBBBBBBBBBBSSSBBBSSSBBBBBBBBSSTTTTTXXSSSSSSSSTSSSSSSTKTKKKKKKKKKTKTSSTDTDDDDDDDDDTDTSSPPP
PPPTTTSSTTTTBBBBBBBBBBBBSSBBSSSBBBBBBBBSSTTTTTXXSSSSSSSSSTSSSSSTKTTTTTTTTTTTKTSSTDTTTTTTTTTTTDTSSPPP
PPPTTTTSSTTBBBBBBBBBBBBBBSSSSSBBBBBBBBBSTTTTTTXXSSSSSSSSSTSSSSSTKKKKKKKKKKKKKTSSTDDDDDDDDDDDDDTSSPPP
PPPTTTTSSTTBBBBBBBBBBBBBBBBSSBBBBBBBBBBSTTTTTTXXSSSSSSSSSSTSSSSTTTTTTTTTTTTTTTSSTTTTTTTTTTTTTTTSSPPP
PPPTTTTSSTTBBBBBBBBBBBBBBBSSSSBBBBBBBBBBTTTTTTXXSSSSSSSSSSTTSSSSSSSSSSSSSSSSSSSSSSSSSSSSSSSSSSSSSPPP
PPPTTTSSTTBBBBBBBBBBBBBBBBBSSBBBBBBBBBBBTTTTTTXXSSSSSSSSSSSTSSSSSSSSSSSSSSSSSSSSSSSSSSSSSSSSSSSSSPPP
PPPTTTSSTTBBBBBBBBBBBBBBBBSSSBBBBBBBBBBBTTTTTTXXSSSSSSSSSSSTTSSSSSSSSSSSSSSSSSSSSSSSSSSSSSSSSSSSSPPP
PPPTTTTSTTTBBBBKKBBBBBBBBBSSBBBBBBBBBBBBTTTTTTXXSSSSSSSSSSSSTSSSSSSSSSSSSSSSSSSSSSSSSSSSSSSSSSSSSPPP
PPPTTTSSTTBBBBBKKBBBBBBBBBSBBBBBBBBBBBBBTTTTTTXXSSSSSSSSSSSSTSSTTTTTTTTTTTTTTTSSTTTTTTTTTTTTTTTSSPPP
PPPTTTSSTTTBBBBBBBBBBBBBBBSSBBBBBBBBBBBBTTTTTTXXSSSSSSSSSSSSSTSTBBBBBBBBBBBBBTSSTAAAAAAAAAAAAATSSPPP
PPPSTTTSSTTBBBBBBBBBBBBBBSSSBBBBBSSDDBBBTTTTTTXXSSSSSSSSSSSSSSTTBTTTTTTTTTTTTTSSTATTTTTTTTTTTTTSSPPP
PPPSSTTSSTTBBBBBBBBBBBBBBSSSSBBSSSSDDBBBTTTTTTXXSSSSSSSSSSSSSSTTBTBBBBBBBBBBBTSSTATAAAAAAAAAAATSSPPP
PPPTSTTSSTTBBBBBBBBBBBBBBBSSSSSSSSBBBBBBTTTTTTXXSSSSSSSSSSSSSTSTBTBTTTTTTTTTBTSSTATATTTTTTTTTATSSPPP
PPPTSSSSSSTBSBBSSSBBSSBSSSSSSSSBSBBBBBBTTTTTTTXXSSSSSSSSSSSSTSSTBTBTBBBBBBBTBTSSTATATAAAAAAATATSSPPP
PPPTTSSSSSSSSSSSSSSSSSSSSSSSBBBBBBBBBBTTTTTTTTXXSSSSSSSSSSSSTSSTBTBTBTTTTTBTBTSSTATATATTTTTATATSSPPP
PPPSSSSSSSSSBSSSBBSBSBBBSSSBBBBBBBBBBBTTTTTTTTXXSSSSSSSSSSSTSSSTBTBTBTBBBTBTBTSSTATATATAAATATATSSPPP
PPPSSSSSTSTTBBSBBBBBBBBBBBSSBBBBBBBBBTTTTTTTTTMMSSSSSSSSSSTTSSSTBTBTBTBTBTBTBTSSTATATATATATATATSSPPP
PPPTTTSSTTTTBBBBBBBBBBBBBBSSBBBBBBBBBTTTTTTTTTMMSSSSSSSSSSTSSSSTBTBTBTBTBTBTBTSSTATATATATATATATSSPPP
PPPTTTTSSTTTBBBBBBBBBBBBBBSBBBBBBBBBBTTTTTTTTTMMSSSSSSSSSTSSSSSTBTBTBTTTBTBTBTSSTATATATTTATATATSSPPP
PPPTTTSSTTTTTBBBBBBBBBBBBBSSBBBBBBBBTTTTTTTTTTMMSSSSSSSSSTTSSSSTBTBTBBBBBTBTBTSSTATATAAAAATATATSSPPP
PPPTTTTSSTTTTBBBBBBKKBBBSSSSBBBBBBBBTTTTTTTTTTMMSSSSSSSSSSTTSSSTBTBTTTTTTTBTBTSSTATATTTTTTTATATSSPPP
PPPTTTTTSSTTTTBBBBBKKBBBBSSSBBBBBBTTTTTTTTTTTTMMSSSSSSSSSSSTTSSTBTBBBBBBBBBTBTSSTATAAAAAAAAATATSSPPP
PPPTTTTSSTTTTTTBBBBBBBBBBBDDBBDDDBDDTTDTDTDDDTMMSDDDSDSSSDDDTTSTBTTTTTTTTTTTBTSSTATTTTTTTTTTTATSSPPP
PPPTTTTTSSTTTTTTBBBBBBBBBBDBDBDBBTDTDTDTDTDTTTMMSDSDSDSSSSSDSTSTBBBBBBBBBBBBBTSSTAAAAAAAAAAAAATSSPPP
PPPTTTTSSTTTTTTTTTBBBBBBBBDBDBDDDTDDTTDTDTDTDTMMSDDDSDSSSSDSTSTTTTTTTTTTTTTTTTSSTTTTTTTTTTTTTTTSSPPP
PPPTTTSSTTTTTTTTTTTTTTTTTBDSDTDTTTDTDTDTDTDTDTMMSDSSSDSSSDSSTTTSSSSSSSSSSSSSSSSSSSSSSSSSSSSSSSSSSPPP
PPPTTTTSSTTTTTTTTTTTTTTTTSDDTTDDDTDDTTDDDTDDDTMMSDSSSDDDSDDDTSTTSSSSSSSSSSSSSSSSSSSSSSSSSSSSSSSSSPPP
PPPTTTTTSSTTTTTTTTTTTTTTTTSSTTTTTTTTTTTTTTTTTTMMSSSSSSSSSSTTSSSTTSSSSSSSSSSSSSSSSSSSSSSSSSSSSSSSSPPP
PPPPPPPPPPPPPPPPPPPPPPPPPPPPPPPPPPPPPPPPPPPPPPPPPPPPPPPPPPPPPPPPPPPPPPPPPPPPPPPPPPPPPPPPPPPPPPPPPPPP
PPPPPPPPPPPPPPPPPPPPPPPPPPPPPPPPPPPPPPPPPPPPPPPPPPPPPPPPPPPPPPPPPPPPPPPPPPPPPPPPPPPPPPPPPPPPPPPPPPPP
PPPPPPPPPPPPPPPPPPPPPPPPPPPPPPPPPPPPPPPPPPPPPPPPPPPPPPPPPPPPPPPPPPPPPPPPPPPPPPPPPPPPPPPPPPPPPPPPPPPP
